12
W|<|>...---....|AHAHAHAHAHA---
|<|>...---|^|...X|BBBBBB|....|
|^|-|^|-.00....0..|.00....0..|
||^CCC4567.....|^||..00|.0.0.|
|^||...|^|...X|BBBBBB|.|X....|
|^|------|^|-.00....0..|0----|
|^|...X|BBB|^|-.00....0..|BBB|
||^|-.00....0..|^CCCCCC......|
|..12340000...|......1182APPLE
|??-----X..|^|-.00....0..|...|
---SEC|^|-.00....0..|RETS-----
|^|------|^|-.00....0..|0----|